Nonsubset_CLL1	QVQLQQWGA.GLLKPSETLSLTCAVYGGSF....SGSFWGWVRQSPGKGLEWIGDITHS...GNTNYNPSLK.SRVTMSVDASKNQFSLNLTSVTAADTAVYYC
Nonsubset_CLL2	QMQLQQWGA.GLLKPSETLSLTCAVYSGSF....NYDSWTWIRQPPGKGLEWIGEVNQT...GTAHYNPSLK.SRVIISIDTSKNQFSLKLTSVTAADTAVFWC
Nonsubset_CLL3	QVHLQQWGA.GLLKPSETLSLTCAVYGGSF....SGYYWSWIRQPPGKGLEWIGEINHS...GSTNYNPSLK.SRVTISVDSSKNQFSLKLSSVTAADTAVYYC
Nonsubset_CLL4	QVQLQQWGA.GLLKPSETLSLTCAVYGGSF....SGYYWSWIRQPPGKGLEWIGEINHR...GNTNYSPSLM.SRLSISVDTSKNQFSLKLNSVTAADTAVYYC
Nonsubset_CLL5	QVQLQQWGA.GLLKPSETLSLTCAVYGGSF....SDYYWSWVRQSPGKGLEWIGEINHS...GSTNYNPSLK.SRVSLSVDTSKNQFSLKLNSVTAADTAVYYC
Nonsubset_CLL6	QVHLPQWGA.GLLKPSDTLSLTCAVYGGTF....SGYYWSWIRQSPGKGLEWIGEIDPS...GNTNYNPSLK.SRVTLSVDTSKNQFSLNLRSVSAADTAVYYC
Nonsubset_CLL7	QVKLQQWGA.GLLKPSETLSLTCAVYGAPV....SDTYWTWIRQPPGKGLEWVGEINHN...GGSNYNPSLK.SRVTISIDASKNQFSLKMTCMKVADTAVYFC
Nonsubset_CLL8	QVQLQQWDT.ELLKPAETLSLTCAVYGGSF....SNYYWTWIRQAPGRGLEWIGHIDHS...GGTNYNPSLR.SRISISMDPSKKHFSLSLTSVSAADTALYYC
Nonsubset_CLL9	QVQLQQWGA.GLLKPSETLSLSCAVYGESF....SGYYWTWIRQPPGEGLEWIGEINHS...GSTNYNPSLK.SRVTISVDTSKNQFSLSLNSVSAADTAVYYC
Nonsubset_CLL10	QVQLQQWGA.GLLKPSETLSLTCAVYGGSF....SGYYWSWIRQPPGKGLEWIGDINYS...GSTNYNPSLE.SRVTISADKSKNQFSLKVRSVTAADTAVYYC
Nonsubset_CLL11	QVQLQQWGA.GLLKPSETLSLTCAVYGGSF....SGYYWSWIRQPPGKGLEWIGEINHS...GSTNYNPSLK.SRVTISVDTSKNQFSLKLSSVTAADTAVYYC
Nonsubset_CLL12	........A.GLLKPSETLSLTCAVYGGSF....SDYYWSWIRQPPGKELEWIGEINHR...GSTNYNPSLE.SRVTISVDTSKNQFSLRLTSVTAVDTAMYYC
Nonsubset_CLL13	........A.GLLRPSETLFLTCAVYGGSF....RGNYWGWIRQTPGKGLEWIGEINHS...GSTNYNPSLK.SRVTMSIDTSKNQFSLKLRSVTAADTAVYYC
Nonsubset_CLL14	QVQLHQWGA.GLLKPSETLSLTCAVYGGSF....RAYYWSWIRQSPGKGLEWIGEINHS...GGTNYNPSLK.SRVTISVDTSKKQFSLKLRSVTVADTAVYYC
Nonsubset_CLL15	QVQLQQWGA.GLVKPSETLSLTCAVYGGSF....SGSYWNWIRQPPGKGLEWIGEINHS...GGTNYSPSLK.SRVTISVDTSKKQFSLNLNAVTAADTAVYYC
Nonsubset_CLL16	QVRLQQWGA.GLLRPSETLSLRCAVYGGSF....RGYYWTWIRQPPGKGLEWIGEINHS...GTTNYNPSLE.NRVTISVDTSKNQFSLEVNSVTAADTAVYYC
Nonsubset_CLL17	QVHLQQWGA.GLLKPSETLSLTCAVYGGSF....SGYHWNWIRQPPGQGLEWIGEINRG...GSTNFNPSLK.SRVTLSVDTSKNQVFLKLTSVTAADTAVYYC
Nonsubset_CLL18	QVQLQQWGA.GLLKPSETLSLTCAVYGGSF....SDYYWTWVRQPPGKGLEWIGEINDW...GSTNYNPSLK.SRVTISVDTSKNQFSLKVRSMTAADTAVYYC
Nonsubset_CLL19	QVQLQQWGA.GLLKPSETLSLTCAVYGGSF....SGYYWSWIRQAPGKGLEWIGEINHS...GSTNYNPSLK.SRVTISVDTSKNQFSLRLSSVTAADTAVYYC
Nonsubset_CLL20	QVQLQQWGA.GLLKPSETLSLTCAVYGGSF....SGYYWSWIRQPPGKGLEWIGEINHS...GSTNYNPSLK.SRVTISVDTSKNQFSLKLSSVTAADTAVYYC
Nonsubset_CLL21	QVQLQQWGA.GLLKPSETLSLTCAVYGGSF....SGYYWSWIRQPPGKGLEWIGEINHS...GSTNYNPTLK.SRVTILVDTSKNQFSLELSSVTAADTAVYYC
Nonsubset_CLL22	QVQLQQWGA.GLLKPSETLSLTCAVYGGSF....SDYYWTWIRQPPGKGLEWIGEIDHT...GSANYNPSLK.SRVTMSVDTSKSQFSLRLTSATAADTAVYYC
Nonsubset_CLL23	QVQLQQWGA.GLLRASETLSLTCTVSGASF....STYYWVWIRQSPGKGLEWIGEVHHG...GGTTYNPSLK.SRVTISADTSKNQFSLELNSVTAADTAVYYC
Nonsubset_CLL24	QVRLQQWGA.GLLKPSETLSLTCAVYGASF....GNNYWSWIRQPPGRGLEWIGEINHS...GNTYYNPSLK.SRVSISVDTSRKQFSLKLTSVTAADTAVYYC
Nonsubset_CLL25	........A.GLLKPSETLSLTCAVYGGSF....SGYYWSWIRQPPGKGLEWIGEINHS...GSTNYNPSLK.SRVTISVDTSKNQFSLKLSSVTAADTAVYYC
Nonsubset_CLL26	QVHLQQWGA.GLLKPSETLSLTCAVYGETF....SGFYWSWIRQSPGKGLEWIGEINPS...GSTNYNPSLK.SRVTLSVDTSKNQFSLKLSSVTAADTAVYYC
Nonsubset_CLL27	QVQLHQWGA.GLLKPSETLFLTCAVYGGSF....SAYYWSWIRQPPGKGLEWIGEINHS...GSTNYNPSLK.SRVTISVDTSKNQFSLKMSSVTAADTAVYYC
Nonsubset_CLL28	QVQLQQWGA.GLLKPSETLSLTCAVYGDSF....SGYYYNWIRQPPGKGLEWIGEINHS...GITYYNPSLR.SRVTISVDTSKSQFSLMLTSVTAADTAVYYC
Nonsubset_CLL29	QVQLQQWGA.GLLKPSETLSLTCAVYGGSF....NDRFWTWIRQPPGKGLEWIGEINHG...GNTKYNPSLI.SRVTISMDTSKNQFSLNLNSVTAADTAVYYC
Nonsubset_CLL30	QVQLQQWGA.GLLKPSETLSLTCAVYGGSF....SGYYWSWIRQPPGKGLEWIGEINHS...GSTNYNPSLK.SRVTISVDTSKNQFSLKLSSVTAADTAVYYC
Nonsubset_CLL31	QVQLQQWGE.GLLKPSETLSLTCAVYGGSF....SGYYWTWIRQPPGRGPEWIGEIDDS...GRTNQNPSLK.SRVTILKDMSKNQISLRVRSVTAADTALYYC
Nonsubset_CLL32	........A.GLLKPSETLSLTCAVYGASL....SDYYWSWIRQPPGKGLEWIGEINHS...GSTDNSPSLK.SRVTISIDTSKTQFSLKLRSVTAADTAVYYC
Nonsubset_CLL33	QVHLQQWGT.GLLKPSETLSRTCAVYGGSF....SGHYWTWIRQPPGKGLEWIGEINHS...GSTNHNPSLK.SRVTISVDTSKNQFSLKLNSVTAADTAVYYC
Nonsubset_CLL34	QVQLQQWGA.GLLKPSETLSLTCAVYGGSF....SGYYWSWIRQSPGKGLEWIGEINHS...GRTNYNPSLK.SRVTISVDTSKNQFSLKMTSVTAADTALYYC
Nonsubset_CLL35	QVQLQQWGA.GLLKPSETLSLTCAVYGGSF....SGYYWSWIRQSPGKGLQWIGEISHS...GNTNYNPSLK.SRVTVLVDTSKNQFSLKINSVTAADTAVYYC
Nonsubset_CLL36	QVHLQQWGA.GLLKPSEALSLTCAVHGGSF....SGHYWTWIRQPPGKGLEWLGEINHS...GSTNNSTSLK.SRVSISVDTSKNQFSLYLKSVTAADTAMYYC
Nonsubset_CLL37	QVLLQQWGA.GLLESSATLSVTCAVYGASL....SDYSWTWIRQAPGKGLEWIAEVSHN...GNTNYNPSLK.SRVTMSVATSKNQFSLQLTSITAADTAVYYC
Nonsubset_CLL38	QVPLQQWGA.GLLKASETLSLTCAVYGGSF....SGYYWTWIRQSSGKGLEWIGEINHS...EITSYNPSLQ.SRVSISMDMSKNQFSLNLKSATAADTAIYYC
Nonsubset_CLL39	QVQLQQWGA.GLLKPSETLSLTCAVYGESF....SGYYWTWIRQPPGKGLEWIGEINHS...GSANYNPSLK.SRVAMSVDPSKNQFSLKLSSVTAADTAVYYC
Nonsubset_CLL40	QVQLQQWGA.GLLKPSETLSLTCAVYGGSF....SAFYWSWIRQPPEKGLEWIGEINHS...GSTNYNPSLK.SRVTVSVDTSKNQFSLQLNSVTAADTAVYYC
Nonsubset_CLL41	QVQLQQWGA.GLLKPSETLSLTCAVYGGSF....SDYYWSWIRQPPGKGLEWIGEVDYR...GGTSYNPSLK.SRVTMSVDTSKNQFSLNVNSVAAPDTAVYYC
Nonsubset_CLL42	QVQLQQWGA.GLLKPSETLSLTCAVYGGSF....SGYYWSWIRQPPGKGLEWIGEINHS...GSTNYNPSLK.SRVTISVDTSKNQFSLKLSSVTAADTAVYYC
Nonsubset_CLL43	QVQLQQWGT.GLLKPSETLSLTCAVYIGSF....RGYYWSWIRQPPGKGLEWIAEINHS...GDTNNNPSLK.SRLTISVDTSKNQFSLQLRSVTAADTAVYYC
Nonsubset_CLL44	QVRLQQWGT.GLLKPMETLSLTCAVYGGSF....SGYYWTWIRQPPGKGLEWIGEIDHT...GGTNYSPSLK.SRVTMSVDTSKNQVSLSLSSATAADTAIYFC
Nonsubset_CLL45	QVHLQQWGA.GLLKPSETLSLTCAVYGGSF....SGYYWTWIRQPPGKGLEWIGQINHS...GSTNYNPSLK.SRVTISVDTSKKQFSLKVNSVTAADTAVYYC
Nonsubset_CLL46	QVPLRQWGV.GLVKPSETLSLTCAVYGGSF....TGYYWTWIRQAPGKGLEWIGEVIRG...GTTRYNPSLE.NRLTLSMDASKNQFSLRLSTVTAADTAVYYC
Nonsubset_CLL47	QVQLQQWGA.GLLKPSETLSLTCAVYGGSF....SGYYWSWIRQPPGKGLEWIGEINHS...GSTNYNPSLK.SRVTISVDTSKNQFSLKLSSVTAADTAVYYC
Nonsubset_CLL48	QVQLQQWGA.GLLKPSETLSLTCGVYGGSF....SGYYWSWIRQPPGKGLEWIGEINHS...GSTNYNPSLK.SRVTISVDTSKNQFSLKLRSVTAADTAVYYC
Nonsubset_CLL49	QVQMQESGP.GMVKPSETLSLTCTVSGGSI....SSYYWSWIRQPAGKGLEWIGRIYTS...GSTNYNPSLK.SRVTMSVDTSKNQFSLKLSSVTAADTAVYYC
Nonsubset_CLL50	QVRIQQWGA.GLLKPSGTLSLNCAVYGGSF....SGYSWSWIRQPPGKGLEWIGEINHS...GSTNYNPSLK.SRVTISVDTSKNQFSLKLRSVAAADTAVYYC
Nonsubset_CLL51	........A.GLLKPSETLALTCAVYGGSF....SGYYWSWIRQPPGKGLEWIGEIYHT...GSTNYNPSLK.SRVTISVDTSKNQFSLSLTSVTAADTAVYYC
Nonsubset_CLL52	QVHLQQWGA.GLLKPSETLSLTCAVYGGSF....SGYYWSWIRQPPGRGLEWIGEINHS...GSTNYNSSLK.SRLTLSVDTSRNQFSLKLSLVTAADTAVYYC
Nonsubset_CLL53	QVLLQQWGA.GLLKPSETLSLTCAVYGGSF....SGYYWTWIRQPPGEGLEWIGEVNHS...GNTNYHPSLK.SRVTISVDTSKNQFSLKLTSVTAADTAVYFC
Nonsubset_CLL54	QVQLQQWGA.GLLKPSETLSLTCAVYGGSF....SGYYWSWIRQPPGKGLEWIGEINHS...GSTNYNPSLK.SRVTISVDTSKNQFSLKLSSVTAADTAVYYC
Nonsubset_CLL55	QVQLQQWGA.GLLKPSETLSLTCAVYGGSF....SGYYWSWIRQPPGKGLEWIGEINHS...GSTNYNPSLK.SRVTISVDTSKNQFSLKLSSVTAADTAVYYC
Nonsubset_CLL56	QVQLQQWGA.GLLKPSETLSLTCDVYGGSF....SGYYWSWIRQPPGKGLEWIGEINHS...GSTNYNPSLK.SRVTISVDTSKNQFSLKLSSVTAADTAVYYC
Nonsubset_CLL57	QVRLQQWGA.GLLKPSEILSLTCAVYGDSF....SGYYWAWIRQPPGKGLEWIGEINRG...GSTNYNPSLK.SRVTITIDTSKNQFSLTLTSATAADTAVYYC
Nonsubset_CLL58	........A.GLLKASETLSLTCAVYGGSF....SGYYWTWIRQPPGKGLGWIGEISHD...GTTNYNPSLE.SRITISVDTSKNQFSLRLTSVSAADTAFYYC
Nonsubset_CLL59	........A.GLLKPSETLSLTCAVYGGSF....SGYYWSWIRQPPGKGLEWIGEINHS...GSTNYNPSLK.SRVTISVDTSKNQFSLKLSSVTAADTAVYYC
Nonsubset_CLL60	QVQLQQWGA.GLLKPSETLSLTCAVYGESF....SGYYWSWIRQPPEKGLEWIGQIDHS...GSTNYNPSLK.SRVIISVDTSKNQFSLRLTSVAAADTAVYYC
Nonsubset_CLL61	QVQLQQWGA.GLLKPSETLSLTCAVYGGSF....SGYYWNWIRQPPGKGLEWIGEINHS...GSTNYNPSLK.SRVTISLDTSKNQFSLKLRFVTAADTAVYYC
Nonsubset_CLL62	QVQLQQWGA.GLLKPSETLSLTCAVYGGSF....SGYYWSWIRQPPGKGLEWIGEINHS...GSTNYNPSLK.SRVTISVDTSKNQFSLKLSSVTAADTAVYYC
Nonsubset_CLL63	QVQLQQWGA.GLLKPSETLSLTCAVYGGSF....SGYYWSWIRQPPGKGLEWIGEINHS...GSTNYNPSLK.SRVTISVDTSKNQFSLKLSSVTAADTAVYYC
Nonsubset_CLL64	QVQLQQWGA.GLLKPSETLSLTCAVYGGSF....SGYYWSWIRQPPGKGLEWIGEINHS...GSTNYNPSLK.SRVTISVDTSKNQFSLKLSSVTAADTAVYYC
Nonsubset_CLL65	QVQLQQWGA.GLLKPSETLSLTCAVYGGSF....SGYYWSWIRQPPGKGLEWIGEINHS...GSTNYNPSLK.SRVTISVDTSKNQFSLKLSSVTAADTAVYYC
Nonsubset_CLL66	QVQLQQWGA.GLLKPSETLSLTCAVYGGSF....SGYYWSWIRQPPGKGLEWIGEINHS...GSTNYNPSLK.SRVTISVDTSKNQFSLKLSSVTAADTAVYYC
Nonsubset_CLL67	QVQLQQWGA.GLLKPSETLSLTCAVYGGSF....SGYYWSWIRQPPGKGLEWIGEINHS...GSTNYNPSLK.SRVTISVDTSKNQFSLKLSSVTAADTAVYYC
Nonsubset_CLL68	QVQLQQWGA.GLLKPSETLSLTCAVYGGSF....SGYYWSWIRQPPGKGLEWIGEINHS...GSTNYNPSLK.SRVTISVDTSKNQFSLKLSSVTAADTAVYYC
Nonsubset_CLL69	QVQLQQWGA.GLLKPSETLSLTCAVYGGSF....SGYYWSWIRQPPGKGLEWIGEINHS...GSTNYNPSLK.SRVTISVDTSKNQFSLKLSSVTAADTAVYYC
Nonsubset_CLL70	QVQVHQWGA.GLSKPSETLSLTCAVYGESF....SGYYWSWIRQPPGKGLEWIGEINHS...GSTNYNPSLK.SRVTISVETSKNQFSLKLRSVTAADTAVYYC
Nonsubset_CLL71	QVLLHQWGA.GLLKPSETLSLTCAVYGGSF....SSYFWTWIRQPPGKGLQWIGEINHS...GSTNYNPSLT.SRISISVDTSKNQFSLKLSSVTAADTAFYYC
Nonsubset_CLL72	QVLQQQWSA.GLLKPSETLSLTCTVYGGSF....SAYSWTWVRQPPGKALEWIGGVVHG...RVTNYNPSLK.TRVTISLDMSTNQFSLGLSFVTAADTAVYYC
Nonsubset_CLL73	QVQLQQWGA.GLLKPSETLSLTCAVYGGSF....SGYYWSWIRQPPGKGLEWIGEINHS...GSTNYNPSLK.SRVTISVDTSKNQFSLKLSSVTAADTAVYYC
Nonsubset_CLL74	QVQLQQWGA.GLLKPSETLSLTCAVYGGSF....SGYYWSWIRQPPGKGLEWIGEINHS...GSTNYNPSLK.SRVTISVDTSKNQFSLKLSSVTAADTAVYYC
Nonsubset_CLL75	QVQLQQWGA.GLLKPSETLSLTCAVYGGSF....SGYYWSWIRQPPGKGLEWIGEINHS...GSTNYNPSLK.SRVTISVDTSKNQFSLKLSSVTAADTAVYYC
Nonsubset_CLL76	QVQLQQWGA.GLLKPSETLSLTCAVYGGSF....SGYYWSWIRQPPGKGLEWIGEINHS...GSTNYNPSLK.SRVTISVDTSKNQFSLKLSSVTAADTAVYYC
Nonsubset_CLL77	LVQLKQWGA.GLLKPSETLSLTCALYGRSF....SGYYWSWIRQTPGKGLEWIGEIDDS...GSTNYNPSLK.SRVTISIDKSKNQFSLRLRSVTAADSAKYYC
Nonsubset_CLL78	QVQLQQWGA.GLLKPSETLSLTCAVYGGSF....SGHYWTWIRQPPGKGLEWIGRINHS...GSTNYSPSLK.SRVTISIDTSRNQFSLHLSSVTAADTGVYYC
Nonsubset_CLL79	QVQLQQWGA.GLLKPSETLSLTCAVYGGSF....SGYYWSWIRQPPGKGLEWIGEINHS...GSTNYNPSLK.SRVTISVDTSKNQFSLKLSSVTAADTAVYYC
Nonsubset_CLL80	QVQLQQWGA.GLLKPSETLSLTCAVYGGSF....SGYYWSWIRQPPGKGLEWIGEINHS...GSTNYNPSLK.SRVTISVDTSKNQFSLKLSSVTAADTAVYYC
Nonsubset_CLL81	QVQLQQWGA.GLLKPSETLSLTCAVYGGSF....SGYYWSWIRQPPGKGLEWIGEINHS...GSTNYNPSLK.SRVTISVDTSKNQFSLKLSSVTAADTAVYYC
Nonsubset_CLL82	QAQLQQWGA.GLLKPSETLSLTCAVYGGSF....SGYFWSWIRQPPGKGLEWIGEINHS...GSTDYNPSLK.SRVTISVDTSKNQFSLKLNCVTAADTAVYYC
Nonsubset_CLL83	QVQLQQWGA.GLLKPSETLSLTCAVYGGSF....SGYYWSWIRQPPGKGLEWIGEINHS...GSTNYNPSLK.SRVTISVDTSKNQFSLKLSSVTAADTAVYYC